R 800 620

NO textures/002-rooftiles1.xpm
SO textures/002-rooftiles3.xpm
WE textures/002-rooftiles8.xpm
EA textures/StoneUWD.XPM

S textures/pillar.XPM

F 20,22,20
C 40,38,41




11 11111
   10001
   10001 
11110S00111
100000000001 
100111110001
1001   10001
10011111001
1000000001
 11100001 
    1011
1111101
  11101
 11110111
   10001
   10001 
11110001
10000001 
10000001
12000001
11111001
    1001
 1  1001 
    1111
1
  111
