R 800 600
NO textures/WoodbrickD.xpm
SO textures/wood.xpm
WE textures/WoodbrickeagleD.xpm
EA textures/WoodbrickswasD.xpm

S textures/barrel.xpm
F 50,50,140
C 100,0,50



11111111111111111111111111111
10000002001100000000000000001
10110000011100000010000010001
12010020000000002000000010001
10110000011100002000000010001
1000000000110N000111011110001
11110111111111011100000010001
11110111111111211101010010001
11000000110101011100000010001
10001000000000001100000010001
10200000000000001101010010001
11000000110101011111011110001
11110111111101011111011110001
11111111111111111111111111111
