R 640 500
NO textures/BluegreyD.xpm
WE textures/BluegreyswasD.xpm 
SO textures/BluegreyeagleD.xpm
EA textures/002-rooftiles8.xpm

S textures/pillar.XPM
F 50,50,140
C 0,0,50

11111111111111111111111111111
10000002001100000000000000001
1011000001110S000010000010001
10010020000000000000000010001
10110000011100000000000010001
10000000001100200111011110001
11110111111111011100000010001
11110111111111211101010010001
11000000110101011100000010001
10001000000000001100000010001
10200000000000001101010010001
11000000110101011111011110001
11110111111101011111011110001
11111111111111111111111111111
