R 640 500
NO textures/020-brickgreen.xpm
WE textures/020-brickgreybrown.xpm
SO textures/021-brickgreybrownmould1.xpm
EA textures/021-brickgreymould1.XPM

S textures/pillar.XPM
F 50,50,30
C 50,90,50

     11111111111111111111111111111
     10000000001100000000000000001
     1011211001110S000010000010001
     101 1 10000000000000000010001
     10111110011100000000000010001
     10000000001102020111011110001
     11011110111111011100000010001
     11011110111111011101110000001
1111111000000000000011100000111001
11001000000000001100000010001 1001
1200000000000000110101001000111001
1100000011010001111101111000000001
1111011111010101111100000000000001
1111111111011111111111111111111111
        10001
        11011
        11211
        11111