R 500 600

NO textures/StoneUWcrossL.XPM

S textures/pillar.XPM

SO textures/StoneUWD.XPM
WE textures/StoneUWL.XPM
EA textures/StoneUWflagL.XPM



F 0,0,50
C 50,20,30


11 11111
   10001
   10001 
11110S00111
100000000001 
100111110001
1001   10001
10011111001
1000000001
 11100001 
    1011
1111101
  11101
 11110111
   10001
   10001 
111100011111
100000010001
100000000001
120000010001
111110011111
    1001
 1  1001 
    1111
1
  111
