R 500 600

NO textures/018-tilebrowngrey.xpm

S textures/W3d_finalarmor.XPM

WE textures/002-rooftiles3.xpm
SO textures/002-rooftiles8.xpm

EA textures/002-rooftiles1.xpm



F 42,40,40
C 100,80,50




111111111111111111111111111111
1200000000000000000000000000011
10000000000000000000000000000011
100001111111111111111111100000011
100001                  1100000011
100001                   1100000011
100001                    1100000011
100001                     1000W00211
100001                    1100000011
100001                   1100000011
100001                  1100000011
100001111111111111111111100000011
10000000000000000000000000000011
1200000000000000000000000000011
111111111111111111111111111111
