R 100 100
NO textures/BluegreyD.xpm
WE textures/BluegreyswasD.xpm 
SO textures/BluegreyeagleD.xpm
EA textures/002-rooftiles8.xpm

S textures/W3d_finalarmor.XPM
F 50,50,140
C 0,0,50


  1111
  1A01
  1111