R 1920 1080


F 0,0,50
C 50,20,30



      1 1 1 1 1
      1 0 0 0 1
      1 0 0 0 1 
1 1 1 1 0 0 0 1
1 0 0 0 0 0 0 1 
1 0 0 0 0 0 0 1
1 0 0 0 0 0 0 1
1 1 1 1 1 0 0 1
        1 0 0 1
        1 0 0 1 
        1 1 1 1
1
